"aa" = (/turf/Walls/StoneWall,/area/Indoor)
"ab" = (/turf,/area)
"ac" = (/turf/Floors/WoodFloor,/area/Indoor)
"ad" = (/turf/Walls/StoneWall,/turf/Doors/WoodDoor,/area/Indoor)
"ae" = (/turf,/turf/Paths/PathSE,/area)
"af" = (/turf,/turf/Paths/PathEW,/area)
"ag" = (/turf,/turf/Paths/PathSW,/area)
"ah" = (/turf,/turf/Paths/PathNS,/area)
"ai" = (/turf,/turf/Paths/PathNE,/area)
"aj" = (/turf,/turf/Paths/PathNS,/turf/Paths/PathSW,/area)
"ak" = (/turf,/turf/Paths/PathNW,/area)
"al" = (/turf,/turf/Trees/Tree,/area)
"am" = (/turf,/turf/Fences/FenceV,/area)
"an" = (/turf,/turf/Fences/FenceDR,/area)
"ao" = (/turf,/turf/Fences/FenceH,/area)
"ap" = (/turf,/turf/Fences/FenceUL,/area)
"aq" = (/turf,/turf/Paths/PathNS,/turf/Trees/Potted_Tree,/area)
"ar" = (/turf/Grounds/Water/Water,/turf/Grounds/Water/WaterEdge/WaterEdgeN,/area)
"as" = (/turf/Grounds/Water/Bridge,/area)
"at" = (/turf/Grounds/Water/Water,/turf/Grounds/Water/WaterEdge/WaterEdgeN,/turf/Grounds/Water/WaterRock,/area)
"au" = (/turf/Grounds/Water/Water,/turf/Grounds/Water/WaterEdge/WaterEdgeE,/turf/Grounds/Water/WaterEdge/WaterEdgeN,/area)
"av" = (/turf/Grounds/Water/Water,/area)
"aw" = (/turf/Grounds/Water/Water,/turf/Grounds/Water/WaterRock,/area)
"ax" = (/turf/Grounds/Water/Water,/turf/Grounds/Water/WaterEdge/WaterEdgeE,/area)
"ay" = (/turf,/turf/Trees/Jungle_Tree,/area)
"az" = (/turf/Grounds/Water/Water,/turf/Grounds/Water/WaterEdge/WaterEdgeS,/area)
"aA" = (/turf/Grounds/Water/Water,/turf/Grounds/Water/WaterEdge/WaterEdgeS,/turf/Grounds/Water/WaterRock,/area)
"aB" = (/turf/Grounds/Water/Water,/turf/Grounds/Water/WaterEdge/WaterEdgeW,/area)
"aC" = (/turf/Floors/WoodFloor,/obj/Potions/MPotion,/turf/Counter,/area/Indoor)
"aD" = (/mob/People/Guys/Shop_Keeper_Simon,/turf/Floors/WoodFloor,/area)
"aE" = (/turf/Floors/WoodFloor,/turf/Counter,/area/Indoor)
"aF" = (/turf/Floors/WoodFloor,/obj/Watch,/turf/Counter,/area/Indoor)
"aG" = (/turf/Floors/WoodFloor,/obj/Potions/Potion,/turf/Counter,/area/Indoor)
"aH" = (/mob/Enemies/Bandit_AxeMan,/turf,/area)
"aI" = (/turf/Grounds/Water/Water,/turf/Grounds/Water/WaterEdge/WaterEdgeW,/turf/Grounds/Water/WaterRock,/area)
"aJ" = (/turf/Grounds/Water/Water,/turf/Grounds/Water/WaterEdge/WaterEdgeE,/turf/Grounds/Water/WaterRock,/area)
"aK" = (/mob/Enemies/Bandit_Theif,/turf,/area)
"aL" = (/turf/Walls/StoneWall,/turf/Doors/WoodDoorGreen,/area/Indoor)
"aM" = (/turf,/turf/Trees/Potted_Tree,/area)
"aN" = (/obj/Signs/SingShop,/turf,/area)
"aO" = (/turf,/turf/Fences/FenceDL,/area)
"aP" = (/turf,/turf/Flowers/FlowerAlive,/area)
"aQ" = (/mob/Guard/Starter_Town_Guard,/turf,/area)
"aR" = (/turf/Grounds/Dirt,/area)
"aS" = (/turf/Grounds/Sand,/area)
"aT" = (/mob/Enemies/Bandit_Boss1,/turf/Floors/WoodFloor,/area/Indoor)
"aU" = (/obj/Bed,/turf/Floors/WoodFloor,/area/Indoor)
"aV" = (/turf,/turf/Fences,/area)
"aW" = (/turf/Grounds/Dirt,/turf/Paths/PathEW,/area)
"aX" = (/mob/People/Girls/Blond_May,/turf/Grounds/Sand,/area)
"aY" = (/mob/People/Guys/Emo_Bill,/turf/Grounds/Sand,/area)
"aZ" = (/mob/Guard,/turf/Floors/WoodFloor,/area/Indoor)
"ba" = (/obj/Clock,/turf/Walls/StoneWall,/area/Indoor)
"bb" = (/obj/Calender,/turf/Walls/StoneWall,/area/Indoor)
"bc" = (/turf,/turf/Fences/FenceUR,/area)
"bd" = (/turf/Grounds/Dirt,/turf/Paths/PathNS,/area)
"be" = (/obj/PiggyBank,/turf/Floors/WoodFloor,/area/Indoor)
"bf" = (/turf/Floors/WoodFloor,/mob/Dog,/turf/Dog/Bed,/area/Indoor)
"bg" = (/mob/Enemies/Bug,/turf/Floors/WoodFloor,/area/Indoor)
"bh" = (/mob/Enemies/Giant_Bug,/turf/Floors/WoodFloor,/area/Indoor)
"bi" = (/turf/Floors/WoodFloor,/turf/Dog/DogBowl,/area/Indoor)
"bj" = (/turf/Floors/WoodFloor,/turf/MyMat,/area/Indoor)
"bk" = (/obj/MyBed,/turf/Floors/WoodFloor,/area/Indoor)
"bl" = (/turf,/mob/Guard/Stick_Town_Guard,/turf/Paths/PathNS,/area)
"bm" = (/turf/Walls/StoneWall,/turf/Doors/WoodDoor/DoorEmoBill,/area)
"bn" = (/turf/Grounds/Dirt,/turf/Dog/Tree,/area)
"bo" = (/turf/Grounds/Dirt,/turf/Dog/Flower,/area)
"bp" = (/obj/Signs/SignMe,/turf/Grounds/Dirt,/area)
"bq" = (/obj/Signs/SignBill,/turf,/area)
"br" = (/obj/Stick,/turf/Grounds/Dirt,/area)
"bs" = (/turf,/turf/Paths/PathNS,/turf/Paths/PathNE,/area)

(1,1,1) = {"
aaaaaaaaaaaaaaaaaaababababababababababababababababababababababababababababababababababababababababababababababababababababababababababababababababababababababababababababababababababababababababababab
aaacacacacacacacaaababababababababababababababaaaaaaaaaaabababababababababababababababababababababababababababababababababababababababababababababababababababababababababababababababababababababababab
aaacacacacacacacaaababababababababababababababaaacacacaaabababababababababababababababababababababababababababababababababababababababababababababababababababababababababababababababababababababababab
aaacacacacacacacaaababababababababababababababaaacacacaaabababababababababababababababababababababababababababababababababababababababababababababababababababababababababababababababababababababababab
aaacacacacacacacaaababababababababababababababaaaaacaaaaabababababababababababababababababababababababababababababababababababababababababababababababababababababababababababababababababababababababab
aaacacacacacacacaaabababababababababababababababaaacaaababababababababababababababababababababababababababababababababababababababababababababababababababababababababababababababababababababababababab
aaaaadaaaaaaaaaaaaababababaeafafafafafafafafagabaaacaaababababababababababababababababababababababababababababababababababababababababababababababababababababababababababababababababababababababababab
ababahababababababababababahababababababababahabaaacaaababababababababababababababababababababababababababababababababababababababababababababababababababababababababababababababababababababababababab
ababahababababababababababahababababababababahabaaacaaababababababababababababababababababababababababababababababababababababababababababababababababababababababababababababababababababababababababab
ababahababababababababababahababababababababahabaaacaaababababababababababababababababababababababababababababababababababababababababababababababababababababababababababababababababababababababababab
ababahabababaaaaaaaaaaaaabahabaaaaadaaaaaaabahabaaacaaababababababababababababababababababababababababababababababababababababababababababababababababababababababababababababababababababababababababab
ababahabababaaacacacacaaabahabaaacacacacaaabahabaaacaaababababababababababababababababababababababababababababababababababababababababababababababababababababababababababababababababababababababababab
ababahabababaaacacacacadabahabaaacacacacaaabahabaaacaaababababababababababababababababababababababababababababababababababababababababababababababababababababababababababababababababababababababababab
ababahabababaaacacacacaaabahabaaacacacacaaabahabaaacaaababababababababababababababababababababababababababababababababababababababababababababababababababababababababababababababababababababababababab
ababahabababaaacacacacaaabahabaaacacacacaaabahabaaacaaababababababababababababababababababababababababababababababababababababababababababababababababababababababababababababababababababababababababab
ababahabababaaaaaaaaaaaaabahabaaaaaaaaaaaaabahabaaadaaababababababababababababababababababababababababababababababababababababababababababababababababababababababababababababababababababababababababab
ababahababababababababababahababababababababahababahabababababababababababababababababababababababababababababababababababababababababababababababababababababababababababababababababababababababababab
ababahababababababababababahababababababababahababahabababababababababababababababababababababababababababababababababababababababababababababababababababababababababababababababababababababababababab
ababaiafafafafafafafafafafajababababababababaiafafakabababababababababababababababababababababababababababababababababababababababababababababababababababababababababababababababababababababababababab
abababababababababababababahabababababababababababababababababababababababababababababababababababababababababababababababababababababababababababababababababababababababababababababababababababababab
alalalalalababababababababahabababababababababababababababababababababababababababababababababababababababababababababababababababababababababababababababababababababababababababababababababababababab
abalalalabalabababababababahabababababababababababababababababababababababababababababababababababababababababababababababababababababababababababababababababababababababababababababababababababababab
alabalababalabalabababababahabababababababababababababababababababababababababababababababababababababababababababababababababababababababababababababababababababababababababababababababababababababab
ababalalalabalababababababahabababababababababababababababababababababababababababababababababababababababababababababababababababababababababababababababababababababababababababababababababababababab
abalabababalalabalababababahabababababababababababababababababababababababababababababababababababababababababababababababababababababababababababababababababababababababababababababababababababababab
abababababalalabalababababahabababababababababababababababababababababababababababababababababababababababababababababababababababababababababababababababababababababababababababababababababababababab
ababababalabalababababababahabababababababababababababababababababababababababababababababababababababababababababababababababababababababababababababababababababababababababababababababababababababab
abababababalalalabababababahabababababababababababababababababababababababababababababababababababababababababababababababababababababababababababababababababababababababababababababababababababababab
abababalababalababalabababahabababababababababababababababababababababababababababababababababababababababababababababababababababababababababababababababababababababababababababababababababababababab
abababalalalalabalabababababalababababababababababababababababababababababababababababababababababababababababababababababababababababababababababababababababababababababababababababababababababababab
abalababalalalalabalabalalababalabalababalababababababababababababababababababababababababababababababababababababababababababababababababababababababababababababababababababababababababababababababab
ababalababalalalabalalalabababalalabalababababababababababababababababababababababababababababababababababababababababababababababababababababababababababababababababababababababababababababababababab
ababalalabalalabalalabalalabalababababalabalabababababababababababababababababababababababababababababababababababababababababababababababababababababababababababababababababababababababababababababab
alabalabalabababababalabababababalabalabalabalababababababababababababababababababababababababababababababababababababababababababababababababababababababababababababababababababababababababababababab
abababalalalalabababababalabalababababalalababababababababababababababababababababababababababababababababababababababababababababababababababababababababababababababababababababababababababababababab
alalababababalababalabababalabalababababalalabababababababababababababababababababababababababababababababababababababababababababababababababababababababababababababababababababababababababababababab
abababalabababababababalabalababalalabalabalalababababababababababababababababababababababababababababababababababababababababababababababababababababababababababababababababababababababababababababab
abababababababababababababalabalababababalabamalahahahahahahahahahahahahahamabababababababababababababababababababababababababababababababababababababababababababababababababababababababababababababab
abababababababababalabababababababalababalabamahahahahahahahahahahahahahahamabababababababababababababababababababababababababababababababababababababababababababababababababababababababababababababab
abababababababababababababababababababalababamahahahahahahahahahahahahahahamabababababababababababababababababababababababababababababababababababababababababababababababababababababababababababababab
ababababababababababababababalababababalababamahahahahahahahahahahahahahahamabababababababababababababababababababababababababababababababababababababababababababababababababababababababababababababab
abababababababalababababababababababababababamahahahahahahahahahahahahahahamabababababababababababababababababababababababababababababababababababababababababababababababababababababababababababababab
ababababababababababababababababababababababamahahahahahahahahahahahahahahamabababababababababababababababababababababababababababababababababababababababababababababababababababababababababababababab
ababalababalababababababababababababababababamahahahahahahahahahahahahahahamabababababababababababababababababababababababababababababababababababababababababababababababababababababababababababababab
ababababababababababababababababababalabababamahahahahahahahahahahahahahahamabababababababababababababababababababababababababababababababababababababababababababababababababababababababababababababab
abababababababababababababababababababababalamahahahahahahahahahahahahahahamabababababababababababababababababababababababababababababababababababababababababababababababababababababababababababababab
ababababababababababababababababababababababamahahahahahahahahahahahahahahamabababababababababababababababababababababababababababababababababababababababababababababababababababababababababababababab
ababababababababababababalababababanaoaoaoaoapahahahahahahahahahahahahahahamabababababababababababababababababababababababababababababababababababababababababababababababababababababababababababababab
abababababababababababababababababamahahahahahahahahaqaaaaaaaaaaahahahahahamabababababababababababababababababababababababababababababababababababababababababababababababababababababababababababababab
abababababababababababababababababamalahahahahahahahaqaaacacacaaahahahahahamabababababababababababababababababababababababababababababababababababababababababababababababababababababababababababababab
abababababababababababababababababamahahahahahahahahaaaaacacacaaahahahahahamabababababababababababababababababababababababababababababababababababababababababababababababababababababababababababababab
abababababababalabababababababababamahahahahahahahahaaacacacacaaahahahahahamabababababababababababababababababababababababababababababababababababababababababababababababababababababababababababababab
abababababababababababababababababamahahahahalahahahaaacacacacaaahahahahahamabababababababababababababababababababababababababababababababababababababababababababababababababababababababababababababab
abababababababababababababababababamahahahahahahahahaaacacacacaaahahahahahamabababababababababababababababababababababababababababababababababababababababababababababababababababababababababababababab
abababababababababababababababababamahahahahahahahahaaaaadaaaaaaahahahahahamabababababababababababababababababababababababababababababababababababababababababababababababababababababababababababababab
abalalababababababababababababababamahahahahahahahahahahahahahahahahahahahamabababababababababababababababababababababababababababababababababababababababababababababababababababababababababababababab
abalabababababababababababababababamahahahahahahahahahahahahahahahahahahahamabababababababababababababababababababababababababababababababababababababababababababababababababababababababababababababab
abababababababababababababababababamahahahahahahahahahahahahahahahahahahahamabababababababababababababababababababababababababababababababababababababababababababababababababababababababababababababab
arararararararararasasasarararararatararararararararauaoaoaoaoaoaoaoaoaoaoapabababababababababababababababababababababababababababababababababababababababababababababababababababababababababababababab
avavavavavavavavavasasasavavavavavawavavavavavavavavaxababababababababababababababababababababababababababababababababababababababababababababababababababababababababababababababababababababababababab
avavavavavavavavavasasasavavavavavawavavavavavavavavaxababababababababababababababababababababababababababababababababababababababababababababababababababababababababababababababababababababababababab
avavavavavavavavavasasasavavavavavawavavavavavavavavaxababababababababababababababababababababababababababababababababababababababababababababababababababababababababababababababababababababababababab
avavavavavavavavavasasasavavavavavawavavavavavavavavaxayayayayayayayayayayayayayayayayayayayayayabababababababababababababababababababababababababababababababababababababababababababababababababababab
avavavavavavavavavasasasavavavavavawavavavavavavavavaxayayayayayayayayayayayayayayayayayayayayayabababababababababababababababababababababababababababababababababababababababababababababababababababab
azazazazazazazazazasasasazazazazazaAazazavavavavavavaxayayayayayayabababayayayayayayayayayayayayabababababababababababababababababababababababababababababababababababababababababababababababababababab
ababababababababababababababayayayayayayaBavavavavavaxayayayayayayabababababayayayayayayayayayayabababababababababababababababababababababababababababababababababababababababababababababababababababab
aaaaaaaaaaaaaaaaaaabababababayayabababayaBavavavavavaxayayabababababababababayayayayayayayayayayabababababababababababababababababababababababababababababababababababababababababababababababababababab
aaaCacacacacacaDaaabababababayayabababayaBavavavavavaxayayabababababababababayayayayayayayayayayabababababababababababababababababababababababababababababababababababababababababababababababababababab
aaacacacacacaEaFaaabababababayayayayabayaBavavavavavaxayayabababababayayabababababababababayayayabababababababababababababababababababababababababababababababababababababababababababababababababababab
aaaGacacacacacacaaababababababababababayaBavavavavavaxayayayayayaHayayayayayabababababababayayayabababababababababababababababababababababababababababababababababababababababababababababababababababab
aaacacacacacacacaaabababababayayayayabayaIawawawawawaJayayayayayabayayayayayababaKababababayayayabababababababababababababababababababababababababababababababababababababababababababababababababababab
aaaaaLaaaaaaaaaaaaababababababababayabayayabababababayayayayayabababayayayababababababababayayayabababababababababababababababababababababababababababababababababababababababababababababababababababab
abaMahaNaMabababababababababayayayayabababababababababaHababababababayayabababanaoaoabaoaoaOayayabababababababababababababababababababababababababababababababababababababababababababababababababababab
ababahababaMababababababababayayayababayayabababababayayayayabababababaKabababamaaaaadaaaaamayayabababababababababababababababababababababababababababababababababababababababababababababababababababab
aPaPahaPaPanaoaoaoaoaQaoaoaoaoaOayayabayaIawawawawawaJayayayayayayayayayayayayamaaacacacaaamayayabababababababababababababababababababababababababababababababababababababababababababababababababababab
aPaPahaPaPamaRaRaRaRaRaRaRaRaRamayayayayaBavavavavavaxayayayayayayayayayayayayamaaacacacaaamayayabababababababababababababababababababababababababababababababababababababababababababababababababababab
aPaPahaPaPamaRaSaSaSaSaSaSaSaRamayayayayaBavavavavavaxayayayayayayayayayayayayamaaacaTaUaaamayayabababababababababababababababababababababababababababababababababababababababababababababababababababab
aPaPahaPaPamaRaSaSaSaSaSaSaSaRamababababaBavavavavavaxababababababababababababamaaacacacaaamayayabababababababababababababababababababababababababababababababababababababababababababababababababababab
aPaPahaPaPamaRaSaSaSaSaSaSaSaRamababababaBavavavavavaxabanaVaVaVaVaVaVaVaVaVaVapaaacacacaaamayayabababababababababababababababababababababababababababababababababababababababababababababababababababab
aPaPaiafafafaWaSaSaSaSaSaXaYaWafafafafagaBavavavavavaxabamaaaaaaaaaaaaaaaaaaaaaaaaaaadaaaaamayayabababababababababababababababababababababababababababababababababababababababababababababababababababab
aPaPaPaPaPamaRaSaSaSaSaSaSaSaRamabababahaBavavavavavaxabamaaaaacacacacacacacacacacacaZaaaaamayayabababababababababababababababababababababababababababababababababababababababababababababababababababab
aPaPaPaPaPamaRaSaSaSaSaSaSaSaRamabababahaBavavavavavaxabamaabaacacacacacacacacacacacacaaaaamayayabababababababababababababababababababababababababababababababababababababababababababababababababababab
abababababamaRaSaSaSaSaSaSaSaRamabababahaBavavavavavaxabamaaaaacacacacacacacacacacacacbbaabcaoaoaoaoaoaoaoaOabababababababababababababababababababababababababababababababababababababababababababababab
abababababamaRaRaRaRbdaRaRaRaRamabababahaBavavavavavaxabamaaaaacacacacacacacacacacacacaaaaababababababababamabababababababababababababababababababababababababababababababababababababababababababababab
abababababbcaoaoaoaoahaoaoaoaoapabababahaBavavavavavaxabamaaaaadaaaaaaaaaaaaaaaaaaaaaaaaaaababababababababamabababababababababababababababababababababababababababababababababababababababababababababab
ababababababaPaPaPaPahalabababababababahaBavavavavavaxabamababababababababababababababababababababababababalalalalalabababababababababababababababababababababababababababababababababababababababababab
ababababababaPaPaPaPahalabababababababahaBavavavavavaxabamabababababababaeafafafafafafafafafafafafafafafafafafafafababababababababababababababababababababababababababababababababababababababababababab
ababababababaPaPaPaPahalabababababababahaBavavavavavaxabamabababababababahababababababababababababababababalalalalalabababababababababababababababababababababababababababababababababababababababababab
ababaaaaaaaaaaaaaaaaahaaaaaaaaaaaaaaabahaBavavavavavaxabamabababababababahababababababababababababababababamabababalabababababababababababababababababababababababababababababababababababababababababab
ababaabeacacbbbfaUaaahaabgacbhacbgaaabahaBavavavavavaxabamabababababababahababababababababababababababababamabababalabababababababababababababababababababababababababababababababababababababababababab
ababaaacacacacacacaaahaaacacacacacaaabahaBavavavavavaxabamabababababababahababababababababababababababababamabababalabababababababababababababababababababababababababababababababababababababababababab
ababaabiacacbabjbkaaahaabgacacacbgaaabahaBavavavavavaxabbcaoaoaoaoaoaoaMblaMaoaoaoaoaoaoaoaoaoaoaoaoaoaoaoapabababalabababababababababababababababababababababababababababababababababababababababababab
ababaaaaaLaaaaaaaaaaahaaaaaabmaaaaaaabahaBavavavavavaxabababababababababahababababababababababababababababababababalabababababababababababababababababababababababababababababababababababababababababab
ababbnbobdbpaRboboboahaPaPbqahaMamaPabahaBavavavavavaxabababababababababahababababababababababababababababababababalabababababababababababababababababababababababababababababababababababababababababab
ababbrbobdaRaRbobobobsafafafakabamaPabahaBavavavavavaxabababababababababahababababababababababababababababababababalabababababababababababababababababababababababababababababababababababababababababab
ababbobobdboboboboboahabababababamaPabaiasasasasasasasafafafafafafafafafakababababababababababababababababababababalabababababababababababababababababababababababababababababababababababababababababab
ababbobobdboboboboboahabababababamaPababaBavavavavavaxababababababababababababababababababababababababababababababalabababababababababababababababababababababababababababababababababababababababababab
ababababaiafafafafafakabababababamaPababaBavavavavavaxababababababababababababababababababababababababababababababalabababababababababababababababababababababababababababababababababababababababababab
ababababababababababababababababamaPababaBavavavavavaxababababababababababababababababababababababababababababababalabababababababababababababababababababababababababababababababababababababababababab
ababababababababababababababababamaPababaBavavavavavaxababababababababababababababababababababababababababababababalabababababababababababababababababababababababababababababababababababababababababab
"}
